###############################################
#                                             #
#                                             #
#                                             #
##################### #########################
#                     #                       #
#                   # #               @       #
#                   #                         #
###############################################